NO ./textures/grass.xpm
SO ./textures/creeper.xpm
WE ./textures/greystone.xpm
EA ./textures/attack_torch.xpm


F 0,0,0
C 255,255,255


1111111111111111111111111
1000000000110000000000001
1011000001110000000000001
1001000000000000000000001
1111111110110000011100001
10000000001100000111011111
11110111111111011100000011
11110111111111011101010011
11000000110101011100000011
10000000S00000001100000011
10000000000000001101010011
11000001110101011111011111
11110111 1110101 101111001
11111111 1111111 11111111
